11 12
x x x x 3 x 0 x x x x x
x 3 0 0 4 x 1 0 0 0 4 x
x 0 x x x x x x x x 0 x
x 0 x x 2 0 0 0 3 x 0 x
x 0 x x 0 x x x 0 x 0 x
x 2 0 0 1 x x x 0 x 0 x
x x x x x x x x 0 x 0 x
x 3 0 0 0 0 0 0 4 x 0 x
x 0 x x x x x x x x 0 x
x 2 0 0 0 0 0 0 0 0 1 x
x x x x x x x x x x x x